11111111111111111
00100000000000001
10111011111110101
10001010000000101
11101110111111101
10101000100000101
10101011111110101
10101000000010101
10101111111010101
10100000000010001
10111111111110111
10000010001000101
10101010101011101
10101000101000101
10101111111110101
10100000000000000
11111111111111111
