11111111111111111
00100010000010001
10101011101110101
10001000100000101
11111110111111101
10000010100000001
10101110101111101
10100010100000101
10111010101110111
10001000100010001
11101111111111101
10001000000010001
10111111101010101
10000000001010101
11111111111010101
10000000000000100
11111111111111111
