11111111111111111
00000010000010001
11111011101010101
10001000001010101
10111111111010101
10100000100010101
10101110101110111
10100010001000001
10111011111111101
10001000100000001
10101110101111101
10101000101000101
10101011101110101
10101000100010101
10101110111010101
10100000000010000
11111111111111111