11111111111111111
00100000000010001
10111110111011101
10000010001000001
11111011101111101
10001000001000101
10101111111010101
10100000001010101
10111111111010101
10100000000010001
10101111111111111
10101000001000101
10101110101010101
10001000101010001
10111011101011101
10000010000010000
11111111111111111