11111111111111111
00001000001000001
11101011101111101
10100010001000001
10111110111011101
10000010000010001
10111011111110111
10101000001000101
10101111101011101
10001000100010001
11101110111110111
10100010000000001
10111011111011101
10001010001000101
10111010101111101
10000000100000000
11111111111111111
