11111111111111111
00100000000010001
10111010111110101
10100010100000101
10101111101111101
10101000101000101
10101010101011101
10100010101010001
10111010101010101
10001010000010101
11101111111110111
10100000000010001
10111111111011101
10000010001000001
10101110101111101
10100000100000000
11111111111111111