11111111111111111
00000000100000001
11111110101011111
10000010101010001
10111010111010101
10001010001000101
10101111101111101
10101000100000001
10101010111111101
10100010000000101
10111111111011101
10000000101010001
11111110101010111
10100010001000101
10101011101111101
10001000000000000
11111111111111111
