11111111111111111
00001000000010001
11101110111011101
10100010101010001
10111010101010101
10000010100010101
10111110101110111
10001000101000001
11101010101011101
10101010101000101
10101010101111101
10001010101000001
10111110101011101
10001000100010001
11101011111110111
10000010000000000
11111111111111111
