11111111111111111
00000000100000001
11111110101011101
10000000101010101
10111111111010101
10100000001010101
10111110101010101
10100010100010101
10101010111110101
10001010100000101
11111010101111101
10001010101000001
10101010101011111
10100010101000001
10111110101111101
10000000100000000
11111111111111111
