11111111111111111
00001000000000001
11101011111011101
10001000001000101
10111111111010111
10000000001010001
11111111101111101
10001000100000001
10111010111111101
10000010000000101
10111111111011101
10100000001000001
10111011101111111
10001000100000001
11101110111111101
10000000100000000
11111111111111111
